▓▓▓▓▓▓▓▓▓▓▓▓▓▓▓▓▓▓▓▓▓▓▓▓▓▓▓▓▓▓▓▓▓▓▓▓▓▓▓▓▓▓▓▓▓▓▓▓▓▓▓▓▓▓▓▓▓▓▓▓▓▓▓▓▓▓▓▓▓▓▓▓▓▓▓▓▓▓▓▓▓▓▓▓▓▓▓▓▓▓▓▓▓▓▓▓▓▓▓▓▓▓▓▓▓▓▓▓▓▓▓▓▓▓▓▓▓▓▓▓▓▓▓▓▓▓▓▓▓▓▓▓▓▓▓▓▓▓▓▓▓
▓*      ▓▓    ▓▓                                                 ▓▓                ▓▓    ▓▓       ▓▓             ▓▓    ▓▓ ▓▓ ▓▓ ▓▓ ▓▓ ▓▓ ▓▓ ▓
▓ ▓▓ ▓▓ ▓▓ ▓▓ ▓▓ ▓▓ ▓▓ ▓▓ ▓▓▓▓▓ ▓▓ ▓▓ ▓▓ ▓▓ ▓▓ ▓▓▓▓▓ ▓▓ ▓▓ ▓▓ ▓▓▓▓▓▓▓▓▓▓▓ ▓▓▓▓▓▓▓▓ ▓▓ ▓▓ ▓▓ ▓▓▓▓▓▓▓▓▓▓▓ ▓▓ ▓▓ ▓▓▓▓▓ ▓▓ ▓▓▓▓▓▓▓▓▓▓▓▓▓▓▓▓▓▓▓▓▓▓
▓ ▓▓ ▓▓ ▓▓ ▓▓ ▓▓ ▓▓ ▓▓ ▓▓ ▓▓▓▓▓ ▓▓ ▓▓ ▓▓ ▓▓ ▓▓ ▓▓▓▓▓ ▓▓ ▓▓ ▓▓ ▓▓▓▓▓▓▓▓▓▓▓ ▓▓▓▓▓▓▓▓ ▓▓ ▓▓ ▓▓ ▓▓▓▓▓▓▓▓▓▓▓ ▓▓ ▓▓ ▓▓▓▓▓ ▓▓ ▓▓▓▓▓▓▓▓▓▓▓▓▓▓▓▓▓▓▓▓▓▓
▓ ▓▓ ▓▓ ▓▓       ▓▓    ▓▓       ▓▓          ▓▓    ▓▓ ▓▓       ▓▓    ▓▓          ▓▓ ▓▓          ▓▓       ▓▓    ▓▓       ▓▓ ▓▓ ▓▓ ▓▓ ▓▓ ▓▓ ▓▓ ▓
▓ ▓▓ ▓▓ ▓▓▓▓▓ ▓▓▓▓▓▓▓▓▓▓▓ ▓▓ ▓▓▓▓▓ ▓▓▓▓▓▓▓▓▓▓▓ ▓▓ ▓▓▓▓▓▓▓▓ ▓▓▓▓▓ ▓▓ ▓▓ ▓▓ ▓▓ ▓▓▓▓▓ ▓▓ ▓▓▓▓▓▓▓▓▓▓▓ ▓▓ ▓▓▓▓▓▓▓▓▓▓▓ ▓▓ ▓▓▓▓▓▓▓▓▓▓▓▓▓▓▓▓▓▓▓▓▓▓▓▓▓
▓ ▓▓ ▓▓ ▓▓▓▓▓ ▓▓▓▓▓▓▓▓▓▓▓ ▓▓ ▓▓▓▓▓ ▓▓▓▓▓▓▓▓▓▓▓ ▓▓ ▓▓▓▓▓▓▓▓ ▓▓▓▓▓ ▓▓ ▓▓ ▓▓ ▓▓ ▓▓▓▓▓ ▓▓ ▓▓▓▓▓▓▓▓▓▓▓ ▓▓ ▓▓▓▓▓▓▓▓▓▓▓ ▓▓ ▓▓▓▓▓▓▓▓▓▓▓▓▓▓▓▓▓▓▓▓▓▓▓▓▓
▓ ▓▓ ▓▓    ▓▓ ▓▓ ▓▓ ▓▓    ▓▓          ▓▓       ▓▓             ▓▓             ▓▓ ▓▓ ▓▓    ▓▓    ▓▓ ▓▓       ▓▓       ▓▓ ▓▓ ▓▓ ▓▓ ▓▓ ▓▓ ▓▓ ▓▓ ▓
▓▓▓▓▓▓▓ ▓▓▓▓▓▓▓▓ ▓▓▓▓▓ ▓▓ ▓▓▓▓▓ ▓▓ ▓▓ ▓▓▓▓▓▓▓▓ ▓▓▓▓▓▓▓▓▓▓▓ ▓▓▓▓▓ ▓▓▓▓▓ ▓▓▓▓▓ ▓▓▓▓▓ ▓▓ ▓▓ ▓▓ ▓▓ ▓▓ ▓▓ ▓▓ ▓▓ ▓▓ ▓▓▓▓▓ ▓▓▓▓▓▓▓▓ ▓▓▓▓▓▓▓▓▓▓▓▓▓▓▓▓
▓▓▓▓▓▓▓ ▓▓▓▓▓▓▓▓ ▓▓▓▓▓ ▓▓ ▓▓▓▓▓ ▓▓ ▓▓ ▓▓▓▓▓▓▓▓ ▓▓▓▓▓▓▓▓▓▓▓ ▓▓▓▓▓ ▓▓▓▓▓ ▓▓▓▓▓ ▓▓▓▓▓ ▓▓ ▓▓ ▓▓ ▓▓ ▓▓ ▓▓ ▓▓ ▓▓ ▓▓ ▓▓▓▓▓ ▓▓▓▓▓▓▓▓ ▓▓▓▓▓▓▓▓▓▓▓▓▓▓▓▓
▓                ▓▓ ▓▓          ▓▓    ▓▓    ▓▓ ▓▓ ▓▓ ▓▓ ▓▓       ▓▓ ▓▓ ▓▓ ▓▓    ▓▓             ▓▓    ▓▓                   ▓▓    ▓▓ ▓▓ ▓▓ ▓▓ ▓
▓ ▓▓ ▓▓▓▓▓ ▓▓▓▓▓ ▓▓▓▓▓ ▓▓ ▓▓▓▓▓▓▓▓ ▓▓▓▓▓ ▓▓ ▓▓▓▓▓ ▓▓ ▓▓ ▓▓▓▓▓▓▓▓▓▓▓ ▓▓ ▓▓ ▓▓▓▓▓▓▓▓ ▓▓▓▓▓▓▓▓ ▓▓▓▓▓ ▓▓▓▓▓▓▓▓▓▓▓ ▓▓ ▓▓▓▓▓ ▓▓▓▓▓ ▓▓▓▓▓▓▓▓▓▓▓▓▓▓▓▓
▓ ▓▓ ▓▓▓▓▓ ▓▓▓▓▓ ▓▓▓▓▓ ▓▓ ▓▓▓▓▓▓▓▓ ▓▓▓▓▓ ▓▓ ▓▓▓▓▓ ▓▓ ▓▓ ▓▓▓▓▓▓▓▓▓▓▓ ▓▓ ▓▓ ▓▓▓▓▓▓▓▓ ▓▓▓▓▓▓▓▓ ▓▓▓▓▓ ▓▓▓▓▓▓▓▓▓▓▓ ▓▓ ▓▓▓▓▓ ▓▓▓▓▓ ▓▓▓▓▓▓▓▓▓▓▓▓▓▓▓▓
▓ ▓▓ ▓▓          ▓▓    ▓▓ ▓▓ ▓▓       ▓▓    ▓▓ ▓▓ ▓▓       ▓▓ ▓▓             ▓▓       ▓▓ ▓▓          ▓▓ ▓▓    ▓▓    ▓▓ ▓▓       ▓▓ ▓▓ ▓▓ ▓▓ ▓
▓▓▓▓▓▓▓ ▓▓ ▓▓ ▓▓ ▓▓▓▓▓▓▓▓ ▓▓ ▓▓▓▓▓ ▓▓ ▓▓▓▓▓ ▓▓ ▓▓ ▓▓ ▓▓▓▓▓▓▓▓▓▓▓ ▓▓ ▓▓ ▓▓ ▓▓ ▓▓▓▓▓ ▓▓▓▓▓ ▓▓▓▓▓ ▓▓ ▓▓▓▓▓▓▓▓▓▓▓▓▓▓ ▓▓ ▓▓ ▓▓▓▓▓ ▓▓ ▓▓▓▓▓▓▓▓▓▓▓▓▓
▓▓▓▓▓▓▓ ▓▓ ▓▓ ▓▓ ▓▓▓▓▓▓▓▓ ▓▓ ▓▓▓▓▓ ▓▓ ▓▓▓▓▓ ▓▓ ▓▓ ▓▓ ▓▓▓▓▓▓▓▓▓▓▓ ▓▓ ▓▓ ▓▓ ▓▓ ▓▓▓▓▓ ▓▓▓▓▓ ▓▓▓▓▓ ▓▓ ▓▓▓▓▓▓▓▓▓▓▓▓▓▓ ▓▓ ▓▓ ▓▓▓▓▓ ▓▓ ▓▓▓▓▓▓▓▓▓▓▓▓▓
▓ ▓▓ ▓▓       ▓▓       ▓▓ ▓▓ ▓▓ ▓▓       ▓▓          ▓▓ ▓▓ ▓▓ ▓▓    ▓▓                      ▓▓             ▓▓ ▓▓    ▓▓ ▓▓       ▓▓ ▓▓ ▓▓*▓▓ ▓
▓ ▓▓▓▓▓ ▓▓ ▓▓ ▓▓▓▓▓ ▓▓ ▓▓▓▓▓ ▓▓▓▓▓ ▓▓▓▓▓ ▓▓ ▓▓ ▓▓ ▓▓▓▓▓▓▓▓▓▓▓▓▓▓ ▓▓ ▓▓ ▓▓▓▓▓ ▓▓ ▓▓▓▓▓▓▓▓ ▓▓ ▓▓ ▓▓▓▓▓ ▓▓ ▓▓ ▓▓▓▓▓▓▓▓ ▓▓▓▓▓ ▓▓ ▓▓▓▓▓▓▓▓▓▓▓ ▓▓ ▓
▓ ▓▓▓▓▓ ▓▓ ▓▓ ▓▓▓▓▓ ▓▓ ▓▓▓▓▓ ▓▓▓▓▓ ▓▓▓▓▓ ▓▓ ▓▓ ▓▓ ▓▓▓▓▓▓▓▓▓▓▓▓▓▓ ▓▓ ▓▓ ▓▓▓▓▓ ▓▓ ▓▓▓▓▓▓▓▓ ▓▓ ▓▓ ▓▓▓▓▓ ▓▓ ▓▓ ▓▓▓▓▓▓▓▓ ▓▓▓▓▓ ▓▓ ▓▓▓▓▓▓▓▓▓▓▓ ▓▓ ▓
▓             ▓▓          ▓▓    ▓▓       ▓▓             ▓▓ ▓▓             ▓▓       ▓▓                ▓▓    ▓▓ ▓▓ ▓▓             ▓▓ ▓▓ ▓▓    ▓
▓ ▓▓ ▓▓ ▓▓ ▓▓ ▓▓▓▓▓ ▓▓ ▓▓ ▓▓ ▓▓ ▓▓ ▓▓▓▓▓▓▓▓▓▓▓▓▓▓ ▓▓▓▓▓ ▓▓ ▓▓▓▓▓▓▓▓ ▓▓ ▓▓ ▓▓ ▓▓▓▓▓▓▓▓ ▓▓ ▓▓▓▓▓ ▓▓ ▓▓ ▓▓ ▓▓▓▓▓▓▓▓▓▓▓ ▓▓▓▓▓ ▓▓ ▓▓▓▓▓▓▓▓▓▓▓▓▓▓ ▓
▓ ▓▓ ▓▓ ▓▓ ▓▓ ▓▓▓▓▓ ▓▓ ▓▓ ▓▓ ▓▓ ▓▓ ▓▓▓▓▓▓▓▓▓▓▓▓▓▓ ▓▓▓▓▓ ▓▓ ▓▓▓▓▓▓▓▓ ▓▓ ▓▓ ▓▓ ▓▓▓▓▓▓▓▓ ▓▓ ▓▓▓▓▓ ▓▓ ▓▓ ▓▓ ▓▓▓▓▓▓▓▓▓▓▓ ▓▓▓▓▓ ▓▓ ▓▓▓▓▓▓▓▓▓▓▓▓▓▓ ▓
▓    ▓▓                ▓▓    ▓▓             ▓▓ ▓▓    ▓▓          ▓▓       ▓▓    ▓▓ ▓▓ ▓▓ ▓▓    ▓▓    ▓▓       ▓▓ ▓▓       ▓▓ ▓▓    ▓▓ ▓▓    ▓
▓ ▓▓ ▓▓ ▓▓ ▓▓ ▓▓▓▓▓ ▓▓ ▓▓▓▓▓ ▓▓▓▓▓▓▓▓▓▓▓ ▓▓▓▓▓ ▓▓ ▓▓ ▓▓▓▓▓ ▓▓ ▓▓ ▓▓ ▓▓▓▓▓▓▓▓ ▓▓ ▓▓▓▓▓▓▓▓ ▓▓ ▓▓ ▓▓▓▓▓▓▓▓ ▓▓▓▓▓▓▓▓▓▓▓ ▓▓ ▓▓ ▓▓▓▓▓ ▓▓▓▓▓ ▓▓▓▓▓ ▓
▓ ▓▓ ▓▓ ▓▓ ▓▓ ▓▓▓▓▓ ▓▓ ▓▓▓▓▓ ▓▓▓▓▓▓▓▓▓▓▓ ▓▓▓▓▓ ▓▓ ▓▓ ▓▓▓▓▓ ▓▓ ▓▓ ▓▓ ▓▓▓▓▓▓▓▓ ▓▓ ▓▓▓▓▓▓▓▓ ▓▓ ▓▓ ▓▓▓▓▓▓▓▓ ▓▓▓▓▓▓▓▓▓▓▓ ▓▓ ▓▓ ▓▓▓▓▓ ▓▓▓▓▓ ▓▓▓▓▓ ▓
▓ ▓▓    ▓▓       ▓▓ ▓▓    ▓▓                ▓▓          ▓▓             ▓▓       ▓▓ ▓▓ ▓▓             ▓▓    ▓▓ ▓▓ ▓▓ ▓▓       ▓▓          ▓▓ ▓
▓ ▓▓ ▓▓ ▓▓ ▓▓▓▓▓▓▓▓▓▓▓ ▓▓ ▓▓ ▓▓ ▓▓▓▓▓ ▓▓ ▓▓▓▓▓ ▓▓▓▓▓▓▓▓▓▓▓ ▓▓ ▓▓▓▓▓▓▓▓▓▓▓▓▓▓ ▓▓▓▓▓▓▓▓ ▓▓▓▓▓ ▓▓ ▓▓▓▓▓▓▓▓▓▓▓▓▓▓▓▓▓▓▓▓ ▓▓ ▓▓ ▓▓ ▓▓ ▓▓▓▓▓▓▓▓▓▓▓ ▓
▓ ▓▓ ▓▓ ▓▓ ▓▓▓▓▓▓▓▓▓▓▓ ▓▓ ▓▓ ▓▓ ▓▓▓▓▓ ▓▓ ▓▓▓▓▓ ▓▓▓▓▓▓▓▓▓▓▓ ▓▓ ▓▓▓▓▓▓▓▓▓▓▓▓▓▓ ▓▓▓▓▓▓▓▓ ▓▓▓▓▓ ▓▓ ▓▓▓▓▓▓▓▓▓▓▓▓▓▓▓▓▓▓▓▓ ▓▓ ▓▓ ▓▓ ▓▓ ▓▓▓▓▓▓▓▓▓▓▓ ▓
▓    ▓▓ ▓▓                   ▓▓                   ▓▓          ▓▓    ▓▓       ▓▓    ▓▓       ▓▓ ▓▓ ▓▓ ▓▓ ▓▓ ▓▓ ▓▓       ▓▓ ▓▓                ▓
▓▓▓▓ ▓▓ ▓▓▓▓▓ ▓▓ ▓▓ ▓▓▓▓▓ ▓▓▓▓▓ ▓▓▓▓▓ ▓▓▓▓▓▓▓▓ ▓▓▓▓▓ ▓▓ ▓▓ ▓▓ ▓▓▓▓▓ ▓▓▓▓▓ ▓▓ ▓▓ ▓▓ ▓▓ ▓▓ ▓▓▓▓▓ ▓▓▓▓▓▓▓▓▓▓▓▓▓▓▓▓▓▓▓▓▓▓▓ ▓▓▓▓▓ ▓▓▓▓▓ ▓▓▓▓▓ ▓▓▓▓
▓▓▓▓ ▓▓ ▓▓▓▓▓ ▓▓ ▓▓ ▓▓▓▓▓ ▓▓▓▓▓ ▓▓▓▓▓ ▓▓▓▓▓▓▓▓ ▓▓▓▓▓ ▓▓ ▓▓ ▓▓ ▓▓▓▓▓ ▓▓▓▓▓ ▓▓ ▓▓ ▓▓ ▓▓ ▓▓ ▓▓▓▓▓ ▓▓▓▓▓▓▓▓▓▓▓▓▓▓▓▓▓▓▓▓▓▓▓ ▓▓▓▓▓ ▓▓▓▓▓ ▓▓▓▓▓ ▓▓▓▓
▓    ▓▓       ▓▓                ▓▓             ▓▓                ▓▓                ▓▓             ▓▓ ▓▓ ▓▓ ▓▓ ▓▓ ▓▓ ▓▓    ▓▓                ▓
▓▓▓▓▓▓▓▓▓▓▓▓▓▓▓▓▓▓▓▓▓▓▓▓▓▓▓▓▓▓▓▓▓▓▓▓▓▓▓▓▓▓▓▓▓▓▓▓▓▓▓▓▓▓▓▓▓▓▓▓▓▓▓▓▓▓▓▓▓▓▓▓▓▓▓▓▓▓▓▓▓▓▓▓▓▓▓▓▓▓▓▓▓▓▓▓▓▓▓▓▓▓▓▓▓▓▓▓▓▓▓▓▓▓▓▓▓▓▓▓▓▓▓▓▓▓▓▓▓▓▓▓▓▓▓▓▓▓▓▓▓
