▓▓▓▓▓▓▓▓▓▓▓▓▓▓▓▓▓▓▓▓▓▓▓▓▓▓▓▓▓▓▓▓▓▓▓▓▓▓▓▓▓▓▓▓▓▓▓▓▓▓▓▓▓▓▓▓▓▓▓▓▓▓▓▓▓▓▓▓▓▓▓▓▓▓▓▓▓▓▓▓▓▓▓▓▓▓▓▓▓▓▓▓▓▓▓▓▓▓▓▓▓▓▓▓▓▓▓▓▓▓▓▓▓▓▓▓▓▓▓▓▓▓▓▓▓▓▓▓▓▓▓▓▓▓▓▓▓▓▓▓▓
▓*                        ▓▓             ▓▓          ▓▓                         ▓▓                   ▓▓             ▓▓ ▓▓       ▓▓ ▓▓ ▓▓ ▓▓ ▓
▓ ▓▓ ▓▓ ▓▓ ▓▓ ▓▓ ▓▓ ▓▓ ▓▓ ▓▓▓▓▓ ▓▓ ▓▓ ▓▓▓▓▓▓▓▓ ▓▓ ▓▓ ▓▓ ▓▓ ▓▓ ▓▓▓▓▓ ▓▓▓▓▓ ▓▓ ▓▓ ▓▓ ▓▓ ▓▓ ▓▓▓▓▓ ▓▓ ▓▓▓▓▓ ▓▓ ▓▓▓▓▓ ▓▓ ▓▓ ▓▓▓▓▓ ▓▓▓▓▓▓▓▓▓▓▓▓▓▓▓▓
▓ ▓▓ ▓▓ ▓▓ ▓▓ ▓▓ ▓▓ ▓▓ ▓▓ ▓▓▓▓▓ ▓▓ ▓▓ ▓▓▓▓▓▓▓▓ ▓▓ ▓▓ ▓▓ ▓▓ ▓▓ ▓▓▓▓▓ ▓▓▓▓▓ ▓▓ ▓▓ ▓▓ ▓▓ ▓▓ ▓▓▓▓▓ ▓▓ ▓▓▓▓▓ ▓▓ ▓▓▓▓▓ ▓▓ ▓▓ ▓▓▓▓▓ ▓▓▓▓▓▓▓▓▓▓▓▓▓▓▓▓
▓    ▓▓    ▓▓             ▓▓                   ▓▓ ▓▓    ▓▓    ▓▓ ▓▓ ▓▓                            ▓▓ ▓▓       ▓▓             ▓▓ ▓▓ ▓▓ ▓▓ ▓▓ ▓
▓ ▓▓▓▓▓ ▓▓ ▓▓ ▓▓▓▓▓ ▓▓ ▓▓▓▓▓▓▓▓ ▓▓ ▓▓ ▓▓ ▓▓ ▓▓ ▓▓ ▓▓▓▓▓ ▓▓ ▓▓ ▓▓ ▓▓▓▓▓ ▓▓ ▓▓ ▓▓ ▓▓ ▓▓▓▓▓ ▓▓ ▓▓ ▓▓▓▓▓▓▓▓ ▓▓▓▓▓ ▓▓▓▓▓▓▓▓▓▓▓ ▓▓ ▓▓▓▓▓▓▓▓▓▓▓▓▓▓▓▓
▓ ▓▓▓▓▓ ▓▓ ▓▓ ▓▓▓▓▓ ▓▓ ▓▓▓▓▓▓▓▓ ▓▓ ▓▓ ▓▓ ▓▓ ▓▓ ▓▓ ▓▓▓▓▓ ▓▓ ▓▓ ▓▓ ▓▓▓▓▓ ▓▓ ▓▓ ▓▓ ▓▓ ▓▓▓▓▓ ▓▓ ▓▓ ▓▓▓▓▓▓▓▓ ▓▓▓▓▓ ▓▓▓▓▓▓▓▓▓▓▓ ▓▓ ▓▓▓▓▓▓▓▓▓▓▓▓▓▓▓▓
▓          ▓▓       ▓▓ ▓▓    ▓▓                      ▓▓    ▓▓    ▓▓ ▓▓                   ▓▓ ▓▓       ▓▓    ▓▓                   ▓▓ ▓▓ ▓▓ ▓▓ ▓
▓ ▓▓▓▓▓ ▓▓▓▓▓▓▓▓ ▓▓▓▓▓ ▓▓▓▓▓ ▓▓ ▓▓▓▓▓ ▓▓ ▓▓ ▓▓ ▓▓ ▓▓ ▓▓ ▓▓▓▓▓ ▓▓ ▓▓ ▓▓ ▓▓▓▓▓ ▓▓ ▓▓ ▓▓ ▓▓▓▓▓ ▓▓ ▓▓▓▓▓▓▓▓ ▓▓▓▓▓▓▓▓ ▓▓ ▓▓ ▓▓ ▓▓ ▓▓▓▓▓▓▓▓▓▓▓▓▓▓▓▓
▓ ▓▓▓▓▓ ▓▓▓▓▓▓▓▓ ▓▓▓▓▓ ▓▓▓▓▓ ▓▓ ▓▓▓▓▓ ▓▓ ▓▓ ▓▓ ▓▓ ▓▓ ▓▓ ▓▓▓▓▓ ▓▓ ▓▓ ▓▓ ▓▓▓▓▓ ▓▓ ▓▓ ▓▓ ▓▓▓▓▓ ▓▓ ▓▓▓▓▓▓▓▓ ▓▓▓▓▓▓▓▓ ▓▓ ▓▓ ▓▓ ▓▓ ▓▓▓▓▓▓▓▓▓▓▓▓▓▓▓▓
▓       ▓▓    ▓▓ ▓▓       ▓▓       ▓▓    ▓▓    ▓▓ ▓▓    ▓▓ ▓▓       ▓▓       ▓▓    ▓▓ ▓▓    ▓▓             ▓▓ ▓▓    ▓▓ ▓▓    ▓▓ ▓▓ ▓▓ ▓▓ ▓▓ ▓
▓ ▓▓ ▓▓▓▓▓ ▓▓ ▓▓ ▓▓ ▓▓ ▓▓ ▓▓▓▓▓▓▓▓▓▓▓ ▓▓ ▓▓ ▓▓▓▓▓ ▓▓▓▓▓ ▓▓ ▓▓▓▓▓ ▓▓ ▓▓ ▓▓ ▓▓ ▓▓▓▓▓ ▓▓ ▓▓ ▓▓▓▓▓ ▓▓ ▓▓ ▓▓ ▓▓ ▓▓ ▓▓ ▓▓▓▓▓ ▓▓ ▓▓ ▓▓▓▓▓▓▓▓▓▓▓▓▓▓▓▓
▓ ▓▓ ▓▓▓▓▓ ▓▓ ▓▓ ▓▓ ▓▓ ▓▓ ▓▓▓▓▓▓▓▓▓▓▓ ▓▓ ▓▓ ▓▓▓▓▓ ▓▓▓▓▓ ▓▓ ▓▓▓▓▓ ▓▓ ▓▓ ▓▓ ▓▓ ▓▓▓▓▓ ▓▓ ▓▓ ▓▓▓▓▓ ▓▓ ▓▓ ▓▓ ▓▓ ▓▓ ▓▓ ▓▓▓▓▓ ▓▓ ▓▓ ▓▓▓▓▓▓▓▓▓▓▓▓▓▓▓▓
▓             ▓▓                   ▓▓          ▓▓          ▓▓ ▓▓       ▓▓ ▓▓ ▓▓ ▓▓          ▓▓                   ▓▓    ▓▓          ▓▓ ▓▓ ▓▓ ▓
▓ ▓▓ ▓▓▓▓▓ ▓▓ ▓▓▓▓▓▓▓▓ ▓▓▓▓▓ ▓▓▓▓▓▓▓▓ ▓▓ ▓▓ ▓▓ ▓▓▓▓▓ ▓▓ ▓▓ ▓▓ ▓▓ ▓▓ ▓▓▓▓▓ ▓▓ ▓▓ ▓▓▓▓▓ ▓▓ ▓▓▓▓▓▓▓▓ ▓▓▓▓▓ ▓▓▓▓▓▓▓▓▓▓▓▓▓▓ ▓▓ ▓▓ ▓▓ ▓▓▓▓▓▓▓▓▓▓▓▓▓
▓ ▓▓ ▓▓▓▓▓ ▓▓ ▓▓▓▓▓▓▓▓ ▓▓▓▓▓ ▓▓▓▓▓▓▓▓ ▓▓ ▓▓ ▓▓ ▓▓▓▓▓ ▓▓ ▓▓ ▓▓ ▓▓ ▓▓ ▓▓▓▓▓ ▓▓ ▓▓ ▓▓▓▓▓ ▓▓ ▓▓▓▓▓▓▓▓ ▓▓▓▓▓ ▓▓▓▓▓▓▓▓▓▓▓▓▓▓ ▓▓ ▓▓ ▓▓ ▓▓▓▓▓▓▓▓▓▓▓▓▓
▓ ▓▓       ▓▓ ▓▓          ▓▓       ▓▓       ▓▓    ▓▓                               ▓▓ ▓▓ ▓▓    ▓▓       ▓▓          ▓▓    ▓▓    ▓▓ ▓▓ ▓▓ ▓▓ ▓
▓▓▓▓ ▓▓▓▓▓ ▓▓ ▓▓▓▓▓ ▓▓ ▓▓ ▓▓ ▓▓ ▓▓▓▓▓▓▓▓ ▓▓▓▓▓ ▓▓ ▓▓▓▓▓ ▓▓ ▓▓ ▓▓▓▓▓ ▓▓ ▓▓ ▓▓▓▓▓ ▓▓ ▓▓ ▓▓ ▓▓ ▓▓▓▓▓ ▓▓▓▓▓ ▓▓▓▓▓ ▓▓ ▓▓▓▓▓ ▓▓▓▓▓ ▓▓▓▓▓▓▓▓▓▓▓▓▓▓▓▓
▓▓▓▓ ▓▓▓▓▓ ▓▓ ▓▓▓▓▓ ▓▓ ▓▓ ▓▓ ▓▓ ▓▓▓▓▓▓▓▓ ▓▓▓▓▓ ▓▓ ▓▓▓▓▓ ▓▓ ▓▓ ▓▓▓▓▓ ▓▓ ▓▓ ▓▓▓▓▓ ▓▓ ▓▓ ▓▓ ▓▓ ▓▓▓▓▓ ▓▓▓▓▓ ▓▓▓▓▓ ▓▓ ▓▓▓▓▓ ▓▓▓▓▓ ▓▓▓▓▓▓▓▓▓▓▓▓▓▓▓▓
▓ ▓▓             ▓▓ ▓▓       ▓▓       ▓▓    ▓▓       ▓▓                   ▓▓ ▓▓          ▓▓       ▓▓                      ▓▓       ▓▓ ▓▓ ▓▓ ▓
▓ ▓▓▓▓▓ ▓▓ ▓▓ ▓▓ ▓▓ ▓▓ ▓▓ ▓▓▓▓▓ ▓▓ ▓▓ ▓▓ ▓▓ ▓▓ ▓▓▓▓▓ ▓▓ ▓▓ ▓▓ ▓▓ ▓▓ ▓▓ ▓▓ ▓▓ ▓▓ ▓▓ ▓▓ ▓▓▓▓▓ ▓▓▓▓▓ ▓▓▓▓▓ ▓▓▓▓▓▓▓▓▓▓▓▓▓▓▓▓▓ ▓▓ ▓▓ ▓▓ ▓▓▓▓▓▓▓▓▓▓
▓ ▓▓▓▓▓ ▓▓ ▓▓ ▓▓ ▓▓ ▓▓ ▓▓ ▓▓▓▓▓ ▓▓ ▓▓ ▓▓ ▓▓ ▓▓ ▓▓▓▓▓ ▓▓ ▓▓ ▓▓ ▓▓ ▓▓ ▓▓ ▓▓ ▓▓ ▓▓ ▓▓ ▓▓ ▓▓▓▓▓ ▓▓▓▓▓ ▓▓▓▓▓ ▓▓▓▓▓▓▓▓▓▓▓▓▓▓▓▓▓ ▓▓ ▓▓ ▓▓ ▓▓▓▓▓▓▓▓▓▓
▓    ▓▓             ▓▓          ▓▓ ▓▓             ▓▓                ▓▓    ▓▓ ▓▓ ▓▓    ▓▓                      ▓▓ ▓▓          ▓▓       ▓▓ ▓▓ ▓
▓ ▓▓ ▓▓ ▓▓▓▓▓▓▓▓▓▓▓▓▓▓▓▓▓ ▓▓ ▓▓▓▓▓ ▓▓ ▓▓ ▓▓ ▓▓▓▓▓▓▓▓ ▓▓ ▓▓▓▓▓ ▓▓ ▓▓ ▓▓▓▓▓▓▓▓ ▓▓▓▓▓ ▓▓▓▓▓ ▓▓▓▓▓▓▓▓ ▓▓ ▓▓ ▓▓▓▓▓ ▓▓ ▓▓ ▓▓▓▓▓▓▓▓▓▓▓ ▓▓ ▓▓ ▓▓▓▓▓▓▓
▓ ▓▓ ▓▓ ▓▓▓▓▓▓▓▓▓▓▓▓▓▓▓▓▓ ▓▓ ▓▓▓▓▓ ▓▓ ▓▓ ▓▓ ▓▓▓▓▓▓▓▓ ▓▓ ▓▓▓▓▓ ▓▓ ▓▓ ▓▓▓▓▓▓▓▓ ▓▓▓▓▓ ▓▓▓▓▓ ▓▓▓▓▓▓▓▓ ▓▓ ▓▓ ▓▓▓▓▓ ▓▓ ▓▓ ▓▓▓▓▓▓▓▓▓▓▓ ▓▓ ▓▓ ▓▓▓▓▓▓▓
▓ ▓▓       ▓▓    ▓▓                                  ▓▓       ▓▓       ▓▓    ▓▓    ▓▓       ▓▓ ▓▓          ▓▓ ▓▓       ▓▓ ▓▓             ▓▓*▓
▓ ▓▓ ▓▓ ▓▓ ▓▓ ▓▓▓▓▓▓▓▓ ▓▓ ▓▓ ▓▓ ▓▓ ▓▓ ▓▓ ▓▓ ▓▓ ▓▓ ▓▓▓▓▓ ▓▓ ▓▓ ▓▓▓▓▓ ▓▓▓▓▓ ▓▓ ▓▓ ▓▓ ▓▓ ▓▓▓▓▓▓▓▓ ▓▓ ▓▓ ▓▓ ▓▓ ▓▓ ▓▓ ▓▓ ▓▓ ▓▓▓▓▓ ▓▓▓▓▓▓▓▓ ▓▓ ▓▓ ▓
▓ ▓▓ ▓▓ ▓▓ ▓▓ ▓▓▓▓▓▓▓▓ ▓▓ ▓▓ ▓▓ ▓▓ ▓▓ ▓▓ ▓▓ ▓▓ ▓▓ ▓▓▓▓▓ ▓▓ ▓▓ ▓▓▓▓▓ ▓▓▓▓▓ ▓▓ ▓▓ ▓▓ ▓▓ ▓▓▓▓▓▓▓▓ ▓▓ ▓▓ ▓▓ ▓▓ ▓▓ ▓▓ ▓▓ ▓▓ ▓▓▓▓▓ ▓▓▓▓▓▓▓▓ ▓▓ ▓▓ ▓
▓    ▓▓    ▓▓    ▓▓             ▓▓ ▓▓       ▓▓    ▓▓          ▓▓ ▓▓ ▓▓       ▓▓          ▓▓    ▓▓    ▓▓    ▓▓ ▓▓ ▓▓ ▓▓ ▓▓       ▓▓       ▓▓ ▓
▓▓▓▓▓▓▓▓▓▓▓▓▓ ▓▓ ▓▓▓▓▓▓▓▓ ▓▓ ▓▓▓▓▓ ▓▓▓▓▓ ▓▓▓▓▓ ▓▓ ▓▓ ▓▓ ▓▓▓▓▓▓▓▓ ▓▓▓▓▓▓▓▓ ▓▓ ▓▓▓▓▓ ▓▓ ▓▓ ▓▓ ▓▓ ▓▓ ▓▓ ▓▓ ▓▓ ▓▓ ▓▓ ▓▓ ▓▓ ▓▓ ▓▓ ▓▓ ▓▓ ▓▓▓▓▓ ▓▓ ▓
▓▓▓▓▓▓▓▓▓▓▓▓▓ ▓▓ ▓▓▓▓▓▓▓▓ ▓▓ ▓▓▓▓▓ ▓▓▓▓▓ ▓▓▓▓▓ ▓▓ ▓▓ ▓▓ ▓▓▓▓▓▓▓▓ ▓▓▓▓▓▓▓▓ ▓▓ ▓▓▓▓▓ ▓▓ ▓▓ ▓▓ ▓▓ ▓▓ ▓▓ ▓▓ ▓▓ ▓▓ ▓▓ ▓▓ ▓▓ ▓▓ ▓▓ ▓▓ ▓▓ ▓▓▓▓▓ ▓▓ ▓
▓             ▓▓                ▓▓ ▓▓    ▓▓                                                       ▓▓                               ▓▓       ▓
▓▓▓▓▓▓▓▓▓▓▓▓▓▓▓▓▓▓▓▓▓▓▓▓▓▓▓▓▓▓▓▓▓▓▓▓▓▓▓▓▓▓▓▓▓▓▓▓▓▓▓▓▓▓▓▓▓▓▓▓▓▓▓▓▓▓▓▓▓▓▓▓▓▓▓▓▓▓▓▓▓▓▓▓▓▓▓▓▓▓▓▓▓▓▓▓▓▓▓▓▓▓▓▓▓▓▓▓▓▓▓▓▓▓▓▓▓▓▓▓▓▓▓▓▓▓▓▓▓▓▓▓▓▓▓▓▓▓▓▓▓
