▓▓▓▓▓▓▓▓▓▓▓▓▓▓▓▓▓▓▓▓▓▓▓▓▓▓▓▓▓▓▓▓▓▓▓▓▓▓▓▓▓▓▓▓▓▓▓▓▓▓▓▓▓▓▓▓▓▓▓▓▓▓▓▓▓▓▓▓▓▓▓▓▓▓▓▓▓▓▓▓▓▓▓▓▓▓▓▓▓▓▓▓▓▓▓▓▓▓▓▓▓▓▓▓▓▓▓▓▓▓▓▓▓▓▓▓▓▓▓▓▓▓▓▓▓▓▓▓▓▓▓▓▓▓▓▓▓▓▓▓▓
▓*                  ▓▓             ▓▓             ▓▓                ▓▓    ▓▓             ▓▓       ▓▓                   ▓▓                   ▓
▓ ▓▓ ▓▓ ▓▓ ▓▓ ▓▓ ▓▓▓▓▓ ▓▓ ▓▓ ▓▓ ▓▓ ▓▓ ▓▓▓▓▓ ▓▓ ▓▓ ▓▓ ▓▓ ▓▓ ▓▓ ▓▓ ▓▓ ▓▓ ▓▓▓▓▓▓▓▓▓▓▓ ▓▓▓▓▓ ▓▓▓▓▓▓▓▓ ▓▓ ▓▓ ▓▓ ▓▓ ▓▓ ▓▓▓▓▓ ▓▓▓▓▓ ▓▓▓▓▓ ▓▓ ▓▓▓▓▓ ▓
▓ ▓▓ ▓▓ ▓▓ ▓▓ ▓▓ ▓▓▓▓▓ ▓▓ ▓▓ ▓▓ ▓▓ ▓▓ ▓▓▓▓▓ ▓▓ ▓▓ ▓▓ ▓▓ ▓▓ ▓▓ ▓▓ ▓▓ ▓▓ ▓▓▓▓▓▓▓▓▓▓▓ ▓▓▓▓▓ ▓▓▓▓▓▓▓▓ ▓▓ ▓▓ ▓▓ ▓▓ ▓▓ ▓▓▓▓▓ ▓▓▓▓▓ ▓▓▓▓▓ ▓▓ ▓▓▓▓▓ ▓
▓    ▓▓       ▓▓          ▓▓       ▓▓                ▓▓    ▓▓                   ▓▓ ▓▓       ▓▓    ▓▓    ▓▓ ▓▓    ▓▓       ▓▓                ▓
▓▓▓▓▓▓▓ ▓▓ ▓▓▓▓▓ ▓▓▓▓▓ ▓▓▓▓▓ ▓▓ ▓▓▓▓▓ ▓▓ ▓▓ ▓▓▓▓▓ ▓▓ ▓▓ ▓▓ ▓▓ ▓▓▓▓▓ ▓▓▓▓▓ ▓▓▓▓▓ ▓▓▓▓▓▓▓▓▓▓▓ ▓▓ ▓▓ ▓▓ ▓▓ ▓▓ ▓▓▓▓▓ ▓▓▓▓▓ ▓▓ ▓▓▓▓▓ ▓▓▓▓▓ ▓▓ ▓▓ ▓
▓▓▓▓▓▓▓ ▓▓ ▓▓▓▓▓ ▓▓▓▓▓ ▓▓▓▓▓ ▓▓ ▓▓▓▓▓ ▓▓ ▓▓ ▓▓▓▓▓ ▓▓ ▓▓ ▓▓ ▓▓ ▓▓▓▓▓ ▓▓▓▓▓ ▓▓▓▓▓ ▓▓▓▓▓▓▓▓▓▓▓ ▓▓ ▓▓ ▓▓ ▓▓ ▓▓ ▓▓▓▓▓ ▓▓▓▓▓ ▓▓ ▓▓▓▓▓ ▓▓▓▓▓ ▓▓ ▓▓ ▓
▓    ▓▓          ▓▓ ▓▓                ▓▓    ▓▓          ▓▓ ▓▓ ▓▓ ▓▓    ▓▓ ▓▓          ▓▓          ▓▓ ▓▓       ▓▓ ▓▓ ▓▓             ▓▓       ▓
▓ ▓▓ ▓▓ ▓▓▓▓▓ ▓▓▓▓▓ ▓▓ ▓▓ ▓▓ ▓▓▓▓▓ ▓▓ ▓▓▓▓▓ ▓▓ ▓▓ ▓▓▓▓▓ ▓▓ ▓▓ ▓▓▓▓▓ ▓▓ ▓▓▓▓▓▓▓▓ ▓▓ ▓▓ ▓▓ ▓▓▓▓▓▓▓▓▓▓▓ ▓▓ ▓▓ ▓▓ ▓▓ ▓▓ ▓▓ ▓▓ ▓▓▓▓▓ ▓▓ ▓▓▓▓▓ ▓▓ ▓
▓ ▓▓ ▓▓ ▓▓▓▓▓ ▓▓▓▓▓ ▓▓ ▓▓ ▓▓ ▓▓▓▓▓ ▓▓ ▓▓▓▓▓ ▓▓ ▓▓ ▓▓▓▓▓ ▓▓ ▓▓ ▓▓▓▓▓ ▓▓ ▓▓▓▓▓▓▓▓ ▓▓ ▓▓ ▓▓ ▓▓▓▓▓▓▓▓▓▓▓ ▓▓ ▓▓ ▓▓ ▓▓ ▓▓ ▓▓ ▓▓ ▓▓▓▓▓ ▓▓ ▓▓▓▓▓ ▓▓ ▓
▓    ▓▓ ▓▓ ▓▓ ▓▓ ▓▓    ▓▓          ▓▓                ▓▓    ▓▓                      ▓▓       ▓▓       ▓▓          ▓▓    ▓▓          ▓▓ ▓▓ ▓▓ ▓
▓ ▓▓ ▓▓▓▓▓▓▓▓▓▓▓ ▓▓▓▓▓ ▓▓▓▓▓▓▓▓ ▓▓ ▓▓▓▓▓ ▓▓ ▓▓ ▓▓ ▓▓ ▓▓ ▓▓▓▓▓ ▓▓▓▓▓ ▓▓ ▓▓ ▓▓ ▓▓ ▓▓▓▓▓ ▓▓▓▓▓▓▓▓ ▓▓ ▓▓▓▓▓▓▓▓▓▓▓▓▓▓ ▓▓ ▓▓ ▓▓ ▓▓ ▓▓ ▓▓ ▓▓▓▓▓▓▓▓ ▓
▓ ▓▓ ▓▓▓▓▓▓▓▓▓▓▓ ▓▓▓▓▓ ▓▓▓▓▓▓▓▓ ▓▓ ▓▓▓▓▓ ▓▓ ▓▓ ▓▓ ▓▓ ▓▓ ▓▓▓▓▓ ▓▓▓▓▓ ▓▓ ▓▓ ▓▓ ▓▓ ▓▓▓▓▓ ▓▓▓▓▓▓▓▓ ▓▓ ▓▓▓▓▓▓▓▓▓▓▓▓▓▓ ▓▓ ▓▓ ▓▓ ▓▓ ▓▓ ▓▓ ▓▓▓▓▓▓▓▓ ▓
▓       ▓▓ ▓▓          ▓▓ ▓▓                         ▓▓       ▓▓    ▓▓ ▓▓       ▓▓          ▓▓          ▓▓ ▓▓ ▓▓ ▓▓          ▓▓    ▓▓ ▓▓ ▓▓*▓
▓ ▓▓ ▓▓ ▓▓ ▓▓▓▓▓ ▓▓ ▓▓▓▓▓ ▓▓ ▓▓ ▓▓ ▓▓ ▓▓▓▓▓ ▓▓▓▓▓▓▓▓▓▓▓▓▓▓ ▓▓▓▓▓ ▓▓ ▓▓ ▓▓ ▓▓▓▓▓ ▓▓ ▓▓▓▓▓ ▓▓▓▓▓ ▓▓ ▓▓ ▓▓ ▓▓ ▓▓ ▓▓▓▓▓ ▓▓ ▓▓▓▓▓ ▓▓ ▓▓▓▓▓▓▓▓▓▓▓▓▓
▓ ▓▓ ▓▓ ▓▓ ▓▓▓▓▓ ▓▓ ▓▓▓▓▓ ▓▓ ▓▓ ▓▓ ▓▓ ▓▓▓▓▓ ▓▓▓▓▓▓▓▓▓▓▓▓▓▓ ▓▓▓▓▓ ▓▓ ▓▓ ▓▓ ▓▓▓▓▓ ▓▓ ▓▓▓▓▓ ▓▓▓▓▓ ▓▓ ▓▓ ▓▓ ▓▓ ▓▓ ▓▓▓▓▓ ▓▓ ▓▓▓▓▓ ▓▓ ▓▓▓▓▓▓▓▓▓▓▓▓▓
▓             ▓▓          ▓▓                   ▓▓       ▓▓ ▓▓ ▓▓          ▓▓ ▓▓                ▓▓             ▓▓ ▓▓                ▓▓ ▓▓ ▓▓ ▓
▓ ▓▓ ▓▓ ▓▓ ▓▓▓▓▓▓▓▓▓▓▓▓▓▓ ▓▓ ▓▓ ▓▓ ▓▓▓▓▓ ▓▓ ▓▓▓▓▓ ▓▓▓▓▓ ▓▓ ▓▓ ▓▓▓▓▓ ▓▓ ▓▓ ▓▓ ▓▓▓▓▓ ▓▓ ▓▓ ▓▓ ▓▓ ▓▓▓▓▓ ▓▓ ▓▓ ▓▓ ▓▓▓▓▓ ▓▓ ▓▓ ▓▓▓▓▓ ▓▓▓▓▓▓▓▓ ▓▓▓▓
▓ ▓▓ ▓▓ ▓▓ ▓▓▓▓▓▓▓▓▓▓▓▓▓▓ ▓▓ ▓▓ ▓▓ ▓▓▓▓▓ ▓▓ ▓▓▓▓▓ ▓▓▓▓▓ ▓▓ ▓▓ ▓▓▓▓▓ ▓▓ ▓▓ ▓▓ ▓▓▓▓▓ ▓▓ ▓▓ ▓▓ ▓▓ ▓▓▓▓▓ ▓▓ ▓▓ ▓▓ ▓▓▓▓▓ ▓▓ ▓▓ ▓▓▓▓▓ ▓▓▓▓▓▓▓▓ ▓▓▓▓
▓          ▓▓          ▓▓ ▓▓    ▓▓ ▓▓    ▓▓    ▓▓ ▓▓       ▓▓                ▓▓ ▓▓ ▓▓ ▓▓ ▓▓ ▓▓    ▓▓ ▓▓       ▓▓    ▓▓                      ▓
▓ ▓▓▓▓▓ ▓▓ ▓▓ ▓▓ ▓▓ ▓▓ ▓▓▓▓▓▓▓▓ ▓▓▓▓▓ ▓▓ ▓▓ ▓▓ ▓▓▓▓▓ ▓▓ ▓▓ ▓▓ ▓▓ ▓▓ ▓▓ ▓▓▓▓▓ ▓▓▓▓▓▓▓▓ ▓▓ ▓▓▓▓▓ ▓▓ ▓▓ ▓▓ ▓▓ ▓▓▓▓▓ ▓▓▓▓▓ ▓▓▓▓▓ ▓▓ ▓▓▓▓▓ ▓▓ ▓▓▓▓
▓ ▓▓▓▓▓ ▓▓ ▓▓ ▓▓ ▓▓ ▓▓ ▓▓▓▓▓▓▓▓ ▓▓▓▓▓ ▓▓ ▓▓ ▓▓ ▓▓▓▓▓ ▓▓ ▓▓ ▓▓ ▓▓ ▓▓ ▓▓ ▓▓▓▓▓ ▓▓▓▓▓▓▓▓ ▓▓ ▓▓▓▓▓ ▓▓ ▓▓ ▓▓ ▓▓ ▓▓▓▓▓ ▓▓▓▓▓ ▓▓▓▓▓ ▓▓ ▓▓▓▓▓ ▓▓ ▓▓▓▓
▓       ▓▓       ▓▓    ▓▓    ▓▓ ▓▓          ▓▓    ▓▓    ▓▓ ▓▓    ▓▓ ▓▓       ▓▓          ▓▓ ▓▓          ▓▓ ▓▓    ▓▓    ▓▓ ▓▓ ▓▓    ▓▓    ▓▓ ▓
▓ ▓▓▓▓▓▓▓▓ ▓▓▓▓▓ ▓▓ ▓▓ ▓▓▓▓▓ ▓▓ ▓▓ ▓▓ ▓▓ ▓▓ ▓▓ ▓▓ ▓▓▓▓▓ ▓▓ ▓▓ ▓▓ ▓▓▓▓▓ ▓▓ ▓▓▓▓▓▓▓▓ ▓▓ ▓▓ ▓▓▓▓▓ ▓▓▓▓▓ ▓▓ ▓▓▓▓▓ ▓▓ ▓▓ ▓▓ ▓▓ ▓▓ ▓▓ ▓▓ ▓▓ ▓▓▓▓▓ ▓
▓ ▓▓▓▓▓▓▓▓ ▓▓▓▓▓ ▓▓ ▓▓ ▓▓▓▓▓ ▓▓ ▓▓ ▓▓ ▓▓ ▓▓ ▓▓ ▓▓ ▓▓▓▓▓ ▓▓ ▓▓ ▓▓ ▓▓▓▓▓ ▓▓ ▓▓▓▓▓▓▓▓ ▓▓ ▓▓ ▓▓▓▓▓ ▓▓▓▓▓ ▓▓ ▓▓▓▓▓ ▓▓ ▓▓ ▓▓ ▓▓ ▓▓ ▓▓ ▓▓ ▓▓ ▓▓▓▓▓ ▓
▓ ▓▓                         ▓▓                      ▓▓ ▓▓ ▓▓       ▓▓    ▓▓    ▓▓       ▓▓ ▓▓ ▓▓             ▓▓          ▓▓    ▓▓ ▓▓    ▓▓ ▓
▓▓▓▓ ▓▓ ▓▓ ▓▓▓▓▓ ▓▓ ▓▓▓▓▓▓▓▓ ▓▓ ▓▓ ▓▓ ▓▓▓▓▓ ▓▓ ▓▓ ▓▓▓▓▓ ▓▓▓▓▓ ▓▓ ▓▓▓▓▓ ▓▓ ▓▓ ▓▓▓▓▓▓▓▓ ▓▓ ▓▓▓▓▓ ▓▓ ▓▓▓▓▓ ▓▓ ▓▓ ▓▓ ▓▓▓▓▓ ▓▓▓▓▓ ▓▓▓▓▓ ▓▓ ▓▓ ▓▓ ▓
▓▓▓▓ ▓▓ ▓▓ ▓▓▓▓▓ ▓▓ ▓▓▓▓▓▓▓▓ ▓▓ ▓▓ ▓▓ ▓▓▓▓▓ ▓▓ ▓▓ ▓▓▓▓▓ ▓▓▓▓▓ ▓▓ ▓▓▓▓▓ ▓▓ ▓▓ ▓▓▓▓▓▓▓▓ ▓▓ ▓▓▓▓▓ ▓▓ ▓▓▓▓▓ ▓▓ ▓▓ ▓▓ ▓▓▓▓▓ ▓▓▓▓▓ ▓▓▓▓▓ ▓▓ ▓▓ ▓▓ ▓
▓             ▓▓             ▓▓       ▓▓ ▓▓ ▓▓    ▓▓ ▓▓ ▓▓ ▓▓    ▓▓    ▓▓ ▓▓       ▓▓                ▓▓    ▓▓    ▓▓                         ▓
▓▓▓▓▓▓▓ ▓▓ ▓▓ ▓▓▓▓▓ ▓▓▓▓▓ ▓▓ ▓▓ ▓▓ ▓▓ ▓▓ ▓▓ ▓▓ ▓▓▓▓▓▓▓▓ ▓▓ ▓▓ ▓▓ ▓▓ ▓▓ ▓▓ ▓▓ ▓▓ ▓▓ ▓▓ ▓▓ ▓▓ ▓▓ ▓▓ ▓▓ ▓▓ ▓▓ ▓▓ ▓▓ ▓▓ ▓▓ ▓▓ ▓▓ ▓▓▓▓▓ ▓▓ ▓▓ ▓▓ ▓
▓▓▓▓▓▓▓ ▓▓ ▓▓ ▓▓▓▓▓ ▓▓▓▓▓ ▓▓ ▓▓ ▓▓ ▓▓ ▓▓ ▓▓ ▓▓ ▓▓▓▓▓▓▓▓ ▓▓ ▓▓ ▓▓ ▓▓ ▓▓ ▓▓ ▓▓ ▓▓ ▓▓ ▓▓ ▓▓ ▓▓ ▓▓ ▓▓ ▓▓ ▓▓ ▓▓ ▓▓ ▓▓ ▓▓ ▓▓ ▓▓ ▓▓ ▓▓▓▓▓ ▓▓ ▓▓ ▓▓ ▓
▓          ▓▓          ▓▓                   ▓▓    ▓▓ ▓▓ ▓▓                ▓▓                   ▓▓                                  ▓▓       ▓
▓▓▓▓▓▓▓▓▓▓▓▓▓▓▓▓▓▓▓▓▓▓▓▓▓▓▓▓▓▓▓▓▓▓▓▓▓▓▓▓▓▓▓▓▓▓▓▓▓▓▓▓▓▓▓▓▓▓▓▓▓▓▓▓▓▓▓▓▓▓▓▓▓▓▓▓▓▓▓▓▓▓▓▓▓▓▓▓▓▓▓▓▓▓▓▓▓▓▓▓▓▓▓▓▓▓▓▓▓▓▓▓▓▓▓▓▓▓▓▓▓▓▓▓▓▓▓▓▓▓▓▓▓▓▓▓▓▓▓▓▓
