▓▓▓▓▓▓▓▓▓▓▓▓▓▓▓▓▓▓▓▓▓▓▓▓▓▓▓▓▓▓▓▓▓▓▓▓▓▓▓▓▓▓▓▓▓▓▓▓▓▓▓▓▓▓▓▓▓▓▓▓▓▓▓▓▓▓▓▓▓▓▓▓▓▓▓▓▓▓▓▓▓▓▓▓▓▓▓▓▓▓▓▓▓▓▓▓▓▓▓▓▓▓▓▓▓▓▓▓▓▓▓▓▓▓▓▓▓▓▓▓▓▓▓▓▓▓▓▓▓▓▓▓▓▓▓▓▓▓▓▓▓
▓*   ▓▓       ▓▓ ▓▓       ▓▓          ▓▓                      ▓▓ ▓▓ ▓▓ ▓▓                         ▓▓ ▓▓          ▓▓                         ▓
▓ ▓▓▓▓▓ ▓▓▓▓▓ ▓▓▓▓▓ ▓▓ ▓▓ ▓▓ ▓▓ ▓▓▓▓▓ ▓▓ ▓▓ ▓▓ ▓▓▓▓▓▓▓▓ ▓▓ ▓▓▓▓▓▓▓▓▓▓▓▓▓▓ ▓▓ ▓▓ ▓▓▓▓▓ ▓▓ ▓▓ ▓▓ ▓▓ ▓▓ ▓▓ ▓▓▓▓▓ ▓▓▓▓▓ ▓▓ ▓▓ ▓▓ ▓▓ ▓▓ ▓▓ ▓▓▓▓▓ ▓
▓ ▓▓▓▓▓ ▓▓▓▓▓ ▓▓▓▓▓ ▓▓ ▓▓ ▓▓ ▓▓ ▓▓▓▓▓ ▓▓ ▓▓ ▓▓ ▓▓▓▓▓▓▓▓ ▓▓ ▓▓▓▓▓▓▓▓▓▓▓▓▓▓ ▓▓ ▓▓ ▓▓▓▓▓ ▓▓ ▓▓ ▓▓ ▓▓ ▓▓ ▓▓ ▓▓▓▓▓ ▓▓▓▓▓ ▓▓ ▓▓ ▓▓ ▓▓ ▓▓ ▓▓ ▓▓▓▓▓ ▓
▓    ▓▓ ▓▓    ▓▓          ▓▓          ▓▓                      ▓▓    ▓▓ ▓▓          ▓▓ ▓▓             ▓▓    ▓▓       ▓▓                      ▓
▓ ▓▓ ▓▓▓▓▓ ▓▓ ▓▓ ▓▓▓▓▓ ▓▓ ▓▓▓▓▓ ▓▓▓▓▓ ▓▓▓▓▓ ▓▓ ▓▓ ▓▓ ▓▓ ▓▓ ▓▓ ▓▓ ▓▓▓▓▓▓▓▓▓▓▓ ▓▓▓▓▓▓▓▓ ▓▓ ▓▓ ▓▓▓▓▓ ▓▓▓▓▓ ▓▓ ▓▓ ▓▓ ▓▓ ▓▓▓▓▓ ▓▓ ▓▓ ▓▓▓▓▓ ▓▓ ▓▓ ▓
▓ ▓▓ ▓▓▓▓▓ ▓▓ ▓▓ ▓▓▓▓▓ ▓▓ ▓▓▓▓▓ ▓▓▓▓▓ ▓▓▓▓▓ ▓▓ ▓▓ ▓▓ ▓▓ ▓▓ ▓▓ ▓▓ ▓▓▓▓▓▓▓▓▓▓▓ ▓▓▓▓▓▓▓▓ ▓▓ ▓▓ ▓▓▓▓▓ ▓▓▓▓▓ ▓▓ ▓▓ ▓▓ ▓▓ ▓▓▓▓▓ ▓▓ ▓▓ ▓▓▓▓▓ ▓▓ ▓▓ ▓
▓ ▓▓    ▓▓       ▓▓       ▓▓    ▓▓    ▓▓       ▓▓                               ▓▓                ▓▓          ▓▓             ▓▓             ▓
▓▓▓▓ ▓▓▓▓▓▓▓▓ ▓▓ ▓▓ ▓▓▓▓▓ ▓▓▓▓▓ ▓▓▓▓▓ ▓▓ ▓▓ ▓▓ ▓▓ ▓▓ ▓▓▓▓▓ ▓▓▓▓▓ ▓▓ ▓▓ ▓▓ ▓▓ ▓▓ ▓▓ ▓▓▓▓▓ ▓▓ ▓▓▓▓▓ ▓▓▓▓▓ ▓▓ ▓▓ ▓▓ ▓▓ ▓▓ ▓▓ ▓▓ ▓▓ ▓▓▓▓▓▓▓▓▓▓▓ ▓
▓▓▓▓ ▓▓▓▓▓▓▓▓ ▓▓ ▓▓ ▓▓▓▓▓ ▓▓▓▓▓ ▓▓▓▓▓ ▓▓ ▓▓ ▓▓ ▓▓ ▓▓ ▓▓▓▓▓ ▓▓▓▓▓ ▓▓ ▓▓ ▓▓ ▓▓ ▓▓ ▓▓ ▓▓▓▓▓ ▓▓ ▓▓▓▓▓ ▓▓▓▓▓ ▓▓ ▓▓ ▓▓ ▓▓ ▓▓ ▓▓ ▓▓ ▓▓ ▓▓▓▓▓▓▓▓▓▓▓ ▓
▓    ▓▓    ▓▓ ▓▓ ▓▓ ▓▓                      ▓▓          ▓▓    ▓▓          ▓▓    ▓▓                   ▓▓       ▓▓*▓▓    ▓▓       ▓▓       ▓▓ ▓
▓ ▓▓▓▓▓ ▓▓ ▓▓▓▓▓ ▓▓ ▓▓ ▓▓ ▓▓ ▓▓ ▓▓ ▓▓ ▓▓▓▓▓▓▓▓▓▓▓▓▓▓ ▓▓ ▓▓▓▓▓ ▓▓ ▓▓ ▓▓ ▓▓ ▓▓ ▓▓▓▓▓ ▓▓ ▓▓ ▓▓▓▓▓ ▓▓ ▓▓ ▓▓ ▓▓ ▓▓▓▓▓▓▓▓ ▓▓ ▓▓ ▓▓▓▓▓▓▓▓ ▓▓ ▓▓▓▓▓ ▓
▓ ▓▓▓▓▓ ▓▓ ▓▓▓▓▓ ▓▓ ▓▓ ▓▓ ▓▓ ▓▓ ▓▓ ▓▓ ▓▓▓▓▓▓▓▓▓▓▓▓▓▓ ▓▓ ▓▓▓▓▓ ▓▓ ▓▓ ▓▓ ▓▓ ▓▓ ▓▓▓▓▓ ▓▓ ▓▓ ▓▓▓▓▓ ▓▓ ▓▓ ▓▓ ▓▓ ▓▓▓▓▓▓▓▓ ▓▓ ▓▓ ▓▓▓▓▓▓▓▓ ▓▓ ▓▓▓▓▓ ▓
▓             ▓▓          ▓▓ ▓▓       ▓▓ ▓▓       ▓▓                            ▓▓ ▓▓ ▓▓ ▓▓          ▓▓       ▓▓             ▓▓             ▓
▓ ▓▓ ▓▓ ▓▓ ▓▓▓▓▓ ▓▓▓▓▓ ▓▓▓▓▓ ▓▓▓▓▓ ▓▓ ▓▓ ▓▓ ▓▓ ▓▓▓▓▓ ▓▓▓▓▓ ▓▓ ▓▓ ▓▓ ▓▓▓▓▓▓▓▓▓▓▓▓▓▓▓▓▓ ▓▓▓▓▓ ▓▓ ▓▓ ▓▓▓▓▓ ▓▓▓▓▓▓▓▓▓▓▓▓▓▓▓▓▓ ▓▓▓▓▓▓▓▓ ▓▓▓▓▓ ▓▓▓▓
▓ ▓▓ ▓▓ ▓▓ ▓▓▓▓▓ ▓▓▓▓▓ ▓▓▓▓▓ ▓▓▓▓▓ ▓▓ ▓▓ ▓▓ ▓▓ ▓▓▓▓▓ ▓▓▓▓▓ ▓▓ ▓▓ ▓▓ ▓▓▓▓▓▓▓▓▓▓▓▓▓▓▓▓▓ ▓▓▓▓▓ ▓▓ ▓▓ ▓▓▓▓▓ ▓▓▓▓▓▓▓▓▓▓▓▓▓▓▓▓▓ ▓▓▓▓▓▓▓▓ ▓▓▓▓▓ ▓▓▓▓
▓ ▓▓    ▓▓    ▓▓ ▓▓ ▓▓ ▓▓ ▓▓          ▓▓    ▓▓                ▓▓          ▓▓ ▓▓    ▓▓       ▓▓    ▓▓       ▓▓    ▓▓          ▓▓       ▓▓    ▓
▓▓▓▓ ▓▓▓▓▓ ▓▓ ▓▓▓▓▓▓▓▓▓▓▓ ▓▓▓▓▓ ▓▓▓▓▓ ▓▓ ▓▓ ▓▓ ▓▓▓▓▓ ▓▓▓▓▓▓▓▓▓▓▓ ▓▓ ▓▓ ▓▓▓▓▓▓▓▓ ▓▓▓▓▓▓▓▓ ▓▓ ▓▓ ▓▓▓▓▓ ▓▓ ▓▓ ▓▓ ▓▓▓▓▓▓▓▓ ▓▓▓▓▓ ▓▓ ▓▓ ▓▓ ▓▓▓▓▓ ▓
▓▓▓▓ ▓▓▓▓▓ ▓▓ ▓▓▓▓▓▓▓▓▓▓▓ ▓▓▓▓▓ ▓▓▓▓▓ ▓▓ ▓▓ ▓▓ ▓▓▓▓▓ ▓▓▓▓▓▓▓▓▓▓▓ ▓▓ ▓▓ ▓▓▓▓▓▓▓▓ ▓▓▓▓▓▓▓▓ ▓▓ ▓▓ ▓▓▓▓▓ ▓▓ ▓▓ ▓▓ ▓▓▓▓▓▓▓▓ ▓▓▓▓▓ ▓▓ ▓▓ ▓▓ ▓▓▓▓▓ ▓
▓ ▓▓    ▓▓    ▓▓ ▓▓ ▓▓ ▓▓    ▓▓ ▓▓                      ▓▓             ▓▓                                  ▓▓                   ▓▓       ▓▓ ▓
▓▓▓▓ ▓▓▓▓▓ ▓▓ ▓▓▓▓▓▓▓▓▓▓▓ ▓▓▓▓▓ ▓▓▓▓▓▓▓▓ ▓▓▓▓▓▓▓▓ ▓▓ ▓▓▓▓▓ ▓▓▓▓▓ ▓▓ ▓▓▓▓▓ ▓▓ ▓▓▓▓▓ ▓▓▓▓▓ ▓▓ ▓▓▓▓▓ ▓▓ ▓▓ ▓▓▓▓▓ ▓▓▓▓▓ ▓▓ ▓▓ ▓▓ ▓▓ ▓▓ ▓▓ ▓▓ ▓▓▓▓
▓▓▓▓ ▓▓▓▓▓ ▓▓ ▓▓▓▓▓▓▓▓▓▓▓ ▓▓▓▓▓ ▓▓▓▓▓▓▓▓ ▓▓▓▓▓▓▓▓ ▓▓ ▓▓▓▓▓ ▓▓▓▓▓ ▓▓ ▓▓▓▓▓ ▓▓ ▓▓▓▓▓ ▓▓▓▓▓ ▓▓ ▓▓▓▓▓ ▓▓ ▓▓ ▓▓▓▓▓ ▓▓▓▓▓ ▓▓ ▓▓ ▓▓ ▓▓ ▓▓ ▓▓ ▓▓ ▓▓▓▓
▓ ▓▓ ▓▓ ▓▓ ▓▓ ▓▓ ▓▓ ▓▓       ▓▓    ▓▓                ▓▓    ▓▓ ▓▓          ▓▓    ▓▓ ▓▓ ▓▓ ▓▓       ▓▓       ▓▓             ▓▓       ▓▓       ▓
▓▓▓▓ ▓▓▓▓▓▓▓▓▓▓▓▓▓▓▓▓▓ ▓▓▓▓▓ ▓▓▓▓▓▓▓▓▓▓▓ ▓▓▓▓▓ ▓▓ ▓▓ ▓▓ ▓▓▓▓▓ ▓▓ ▓▓▓▓▓ ▓▓ ▓▓ ▓▓ ▓▓ ▓▓ ▓▓▓▓▓ ▓▓ ▓▓▓▓▓ ▓▓ ▓▓ ▓▓▓▓▓▓▓▓▓▓▓▓▓▓ ▓▓ ▓▓ ▓▓ ▓▓ ▓▓▓▓▓ ▓
▓▓▓▓ ▓▓▓▓▓▓▓▓▓▓▓▓▓▓▓▓▓ ▓▓▓▓▓ ▓▓▓▓▓▓▓▓▓▓▓ ▓▓▓▓▓ ▓▓ ▓▓ ▓▓ ▓▓▓▓▓ ▓▓ ▓▓▓▓▓ ▓▓ ▓▓ ▓▓ ▓▓ ▓▓ ▓▓▓▓▓ ▓▓ ▓▓▓▓▓ ▓▓ ▓▓ ▓▓▓▓▓▓▓▓▓▓▓▓▓▓ ▓▓ ▓▓ ▓▓ ▓▓ ▓▓▓▓▓ ▓
▓                ▓▓ ▓▓          ▓▓                   ▓▓ ▓▓ ▓▓       ▓▓             ▓▓    ▓▓       ▓▓          ▓▓ ▓▓ ▓▓          ▓▓          ▓
▓▓▓▓ ▓▓ ▓▓ ▓▓ ▓▓ ▓▓▓▓▓ ▓▓ ▓▓▓▓▓▓▓▓▓▓▓▓▓▓ ▓▓▓▓▓▓▓▓ ▓▓▓▓▓▓▓▓ ▓▓ ▓▓ ▓▓▓▓▓ ▓▓ ▓▓ ▓▓▓▓▓ ▓▓ ▓▓ ▓▓ ▓▓ ▓▓▓▓▓ ▓▓ ▓▓ ▓▓ ▓▓ ▓▓ ▓▓ ▓▓ ▓▓▓▓▓ ▓▓ ▓▓ ▓▓ ▓▓ ▓
▓▓▓▓ ▓▓ ▓▓ ▓▓ ▓▓ ▓▓▓▓▓ ▓▓ ▓▓▓▓▓▓▓▓▓▓▓▓▓▓ ▓▓▓▓▓▓▓▓ ▓▓▓▓▓▓▓▓ ▓▓ ▓▓ ▓▓▓▓▓ ▓▓ ▓▓ ▓▓▓▓▓ ▓▓ ▓▓ ▓▓ ▓▓ ▓▓▓▓▓ ▓▓ ▓▓ ▓▓ ▓▓ ▓▓ ▓▓ ▓▓ ▓▓▓▓▓ ▓▓ ▓▓ ▓▓ ▓▓ ▓
▓       ▓▓    ▓▓          ▓▓ ▓▓       ▓▓    ▓▓ ▓▓    ▓▓    ▓▓       ▓▓ ▓▓    ▓▓    ▓▓       ▓▓          ▓▓                   ▓▓    ▓▓       ▓
▓▓▓▓ ▓▓▓▓▓▓▓▓▓▓▓▓▓▓▓▓▓▓▓▓ ▓▓ ▓▓ ▓▓ ▓▓ ▓▓ ▓▓ ▓▓ ▓▓▓▓▓ ▓▓ ▓▓ ▓▓ ▓▓ ▓▓ ▓▓ ▓▓ ▓▓ ▓▓ ▓▓ ▓▓ ▓▓ ▓▓▓▓▓ ▓▓ ▓▓ ▓▓ ▓▓ ▓▓ ▓▓ ▓▓ ▓▓ ▓▓ ▓▓▓▓▓ ▓▓▓▓▓ ▓▓ ▓▓ ▓
▓▓▓▓ ▓▓▓▓▓▓▓▓▓▓▓▓▓▓▓▓▓▓▓▓ ▓▓ ▓▓ ▓▓ ▓▓ ▓▓ ▓▓ ▓▓ ▓▓▓▓▓ ▓▓ ▓▓ ▓▓ ▓▓ ▓▓ ▓▓ ▓▓ ▓▓ ▓▓ ▓▓ ▓▓ ▓▓ ▓▓▓▓▓ ▓▓ ▓▓ ▓▓ ▓▓ ▓▓ ▓▓ ▓▓ ▓▓ ▓▓ ▓▓▓▓▓ ▓▓▓▓▓ ▓▓ ▓▓ ▓
▓    ▓▓ ▓▓ ▓▓ ▓▓ ▓▓ ▓▓                            ▓▓                         ▓▓       ▓▓ ▓▓       ▓▓             ▓▓ ▓▓          ▓▓          ▓
▓▓▓▓▓▓▓▓▓▓▓▓▓▓▓▓▓▓▓▓▓▓▓▓▓▓▓▓▓▓▓▓▓▓▓▓▓▓▓▓▓▓▓▓▓▓▓▓▓▓▓▓▓▓▓▓▓▓▓▓▓▓▓▓▓▓▓▓▓▓▓▓▓▓▓▓▓▓▓▓▓▓▓▓▓▓▓▓▓▓▓▓▓▓▓▓▓▓▓▓▓▓▓▓▓▓▓▓▓▓▓▓▓▓▓▓▓▓▓▓▓▓▓▓▓▓▓▓▓▓▓▓▓▓▓▓▓▓▓▓▓
