▓▓▓▓▓▓▓▓▓▓▓▓▓▓▓▓▓▓▓▓▓▓▓▓▓▓▓▓▓▓▓▓▓▓▓▓▓▓▓▓▓▓▓▓▓▓▓▓▓▓▓▓▓▓▓▓▓▓▓▓▓▓▓▓▓▓▓▓▓▓▓▓▓▓▓▓▓▓▓▓▓▓▓▓▓▓▓▓▓▓▓▓▓▓▓▓▓▓▓▓▓▓▓▓▓▓▓▓▓▓▓▓▓▓▓▓▓▓▓▓▓▓▓▓▓▓▓▓▓▓▓▓▓▓▓▓▓▓▓▓▓
▓*      ▓▓                            ▓▓       ▓▓    ▓▓ ▓▓                      ▓▓                                              ▓▓          ▓
▓ ▓▓ ▓▓ ▓▓▓▓▓ ▓▓ ▓▓ ▓▓ ▓▓▓▓▓ ▓▓ ▓▓ ▓▓▓▓▓ ▓▓ ▓▓ ▓▓ ▓▓ ▓▓ ▓▓ ▓▓ ▓▓ ▓▓▓▓▓ ▓▓▓▓▓ ▓▓ ▓▓▓▓▓ ▓▓ ▓▓▓▓▓ ▓▓ ▓▓ ▓▓ ▓▓ ▓▓ ▓▓ ▓▓▓▓▓ ▓▓▓▓▓ ▓▓ ▓▓▓▓▓ ▓▓ ▓▓ ▓
▓ ▓▓ ▓▓ ▓▓▓▓▓ ▓▓ ▓▓ ▓▓ ▓▓▓▓▓ ▓▓ ▓▓ ▓▓▓▓▓ ▓▓ ▓▓ ▓▓ ▓▓ ▓▓ ▓▓ ▓▓ ▓▓ ▓▓▓▓▓ ▓▓▓▓▓ ▓▓ ▓▓▓▓▓ ▓▓ ▓▓▓▓▓ ▓▓ ▓▓ ▓▓ ▓▓ ▓▓ ▓▓ ▓▓▓▓▓ ▓▓▓▓▓ ▓▓ ▓▓▓▓▓ ▓▓ ▓▓ ▓
▓    ▓▓    ▓▓    ▓▓ ▓▓    ▓▓                   ▓▓             ▓▓ ▓▓ ▓▓                   ▓▓ ▓▓    ▓▓    ▓▓ ▓▓    ▓▓    ▓▓ ▓▓ ▓▓             ▓
▓ ▓▓▓▓▓ ▓▓▓▓▓ ▓▓ ▓▓ ▓▓ ▓▓ ▓▓ ▓▓ ▓▓▓▓▓ ▓▓ ▓▓ ▓▓▓▓▓▓▓▓ ▓▓▓▓▓▓▓▓ ▓▓▓▓▓ ▓▓▓▓▓ ▓▓ ▓▓▓▓▓ ▓▓ ▓▓▓▓▓ ▓▓ ▓▓ ▓▓ ▓▓ ▓▓▓▓▓ ▓▓ ▓▓▓▓▓ ▓▓ ▓▓ ▓▓▓▓▓ ▓▓ ▓▓ ▓▓ ▓
▓ ▓▓▓▓▓ ▓▓▓▓▓ ▓▓ ▓▓ ▓▓ ▓▓ ▓▓ ▓▓ ▓▓▓▓▓ ▓▓ ▓▓ ▓▓▓▓▓▓▓▓ ▓▓▓▓▓▓▓▓ ▓▓▓▓▓ ▓▓▓▓▓ ▓▓ ▓▓▓▓▓ ▓▓ ▓▓▓▓▓ ▓▓ ▓▓ ▓▓ ▓▓ ▓▓▓▓▓ ▓▓ ▓▓▓▓▓ ▓▓ ▓▓ ▓▓▓▓▓ ▓▓ ▓▓ ▓▓ ▓
▓       ▓▓                         ▓▓             ▓▓       ▓▓       ▓▓ ▓▓ ▓▓       ▓▓          ▓▓ ▓▓    ▓▓ ▓▓ ▓▓    ▓▓       ▓▓ ▓▓       ▓▓ ▓
▓ ▓▓ ▓▓ ▓▓▓▓▓ ▓▓▓▓▓ ▓▓ ▓▓ ▓▓ ▓▓ ▓▓▓▓▓ ▓▓▓▓▓▓▓▓ ▓▓▓▓▓ ▓▓ ▓▓ ▓▓ ▓▓ ▓▓ ▓▓ ▓▓ ▓▓ ▓▓▓▓▓ ▓▓ ▓▓ ▓▓ ▓▓ ▓▓ ▓▓ ▓▓▓▓▓ ▓▓ ▓▓ ▓▓ ▓▓ ▓▓▓▓▓ ▓▓ ▓▓ ▓▓ ▓▓ ▓▓ ▓
▓ ▓▓ ▓▓ ▓▓▓▓▓ ▓▓▓▓▓ ▓▓ ▓▓ ▓▓ ▓▓ ▓▓▓▓▓ ▓▓▓▓▓▓▓▓ ▓▓▓▓▓ ▓▓ ▓▓ ▓▓ ▓▓ ▓▓ ▓▓ ▓▓ ▓▓ ▓▓▓▓▓ ▓▓ ▓▓ ▓▓ ▓▓ ▓▓ ▓▓ ▓▓▓▓▓ ▓▓ ▓▓ ▓▓ ▓▓ ▓▓▓▓▓ ▓▓ ▓▓ ▓▓ ▓▓ ▓▓ ▓
▓ ▓▓                   ▓▓       ▓▓          ▓▓ ▓▓                            ▓▓                      ▓▓    ▓▓    ▓▓                   ▓▓    ▓
▓ ▓▓▓▓▓ ▓▓ ▓▓ ▓▓ ▓▓ ▓▓▓▓▓ ▓▓ ▓▓▓▓▓ ▓▓ ▓▓ ▓▓ ▓▓▓▓▓ ▓▓ ▓▓ ▓▓ ▓▓ ▓▓ ▓▓▓▓▓ ▓▓ ▓▓▓▓▓▓▓▓ ▓▓ ▓▓▓▓▓▓▓▓ ▓▓ ▓▓ ▓▓ ▓▓▓▓▓ ▓▓▓▓▓ ▓▓▓▓▓ ▓▓ ▓▓▓▓▓ ▓▓▓▓▓ ▓▓ ▓
▓ ▓▓▓▓▓ ▓▓ ▓▓ ▓▓ ▓▓ ▓▓▓▓▓ ▓▓ ▓▓▓▓▓ ▓▓ ▓▓ ▓▓ ▓▓▓▓▓ ▓▓ ▓▓ ▓▓ ▓▓ ▓▓ ▓▓▓▓▓ ▓▓ ▓▓▓▓▓▓▓▓ ▓▓ ▓▓▓▓▓▓▓▓ ▓▓ ▓▓ ▓▓ ▓▓▓▓▓ ▓▓▓▓▓ ▓▓▓▓▓ ▓▓ ▓▓▓▓▓ ▓▓▓▓▓ ▓▓ ▓
▓    ▓▓             ▓▓ ▓▓ ▓▓       ▓▓    ▓▓ ▓▓                ▓▓       ▓▓ ▓▓                ▓▓ ▓▓    ▓▓    ▓▓    ▓▓                         ▓
▓ ▓▓▓▓▓ ▓▓ ▓▓ ▓▓▓▓▓ ▓▓ ▓▓▓▓▓ ▓▓ ▓▓ ▓▓ ▓▓ ▓▓ ▓▓ ▓▓▓▓▓▓▓▓ ▓▓ ▓▓ ▓▓▓▓▓▓▓▓▓▓▓ ▓▓▓▓▓ ▓▓ ▓▓ ▓▓ ▓▓ ▓▓▓▓▓ ▓▓ ▓▓▓▓▓ ▓▓ ▓▓ ▓▓ ▓▓ ▓▓▓▓▓▓▓▓ ▓▓ ▓▓▓▓▓ ▓▓ ▓
▓ ▓▓▓▓▓ ▓▓ ▓▓ ▓▓▓▓▓ ▓▓ ▓▓▓▓▓ ▓▓ ▓▓ ▓▓ ▓▓ ▓▓ ▓▓ ▓▓▓▓▓▓▓▓ ▓▓ ▓▓ ▓▓▓▓▓▓▓▓▓▓▓ ▓▓▓▓▓ ▓▓ ▓▓ ▓▓ ▓▓ ▓▓▓▓▓ ▓▓ ▓▓▓▓▓ ▓▓ ▓▓ ▓▓ ▓▓ ▓▓▓▓▓▓▓▓ ▓▓ ▓▓▓▓▓ ▓▓ ▓
▓    ▓▓ ▓▓          ▓▓    ▓▓       ▓▓    ▓▓          ▓▓    ▓▓    ▓▓    ▓▓    ▓▓    ▓▓       ▓▓             ▓▓                ▓▓             ▓
▓ ▓▓ ▓▓▓▓▓ ▓▓ ▓▓ ▓▓▓▓▓ ▓▓ ▓▓▓▓▓ ▓▓ ▓▓ ▓▓ ▓▓ ▓▓ ▓▓▓▓▓▓▓▓ ▓▓▓▓▓ ▓▓ ▓▓ ▓▓ ▓▓ ▓▓▓▓▓▓▓▓▓▓▓ ▓▓ ▓▓▓▓▓ ▓▓ ▓▓▓▓▓ ▓▓▓▓▓ ▓▓▓▓▓ ▓▓ ▓▓ ▓▓▓▓▓ ▓▓▓▓▓ ▓▓ ▓▓ ▓
▓ ▓▓ ▓▓▓▓▓ ▓▓ ▓▓ ▓▓▓▓▓ ▓▓ ▓▓▓▓▓ ▓▓ ▓▓ ▓▓ ▓▓ ▓▓ ▓▓▓▓▓▓▓▓ ▓▓▓▓▓ ▓▓ ▓▓ ▓▓ ▓▓ ▓▓▓▓▓▓▓▓▓▓▓ ▓▓ ▓▓▓▓▓ ▓▓ ▓▓▓▓▓ ▓▓▓▓▓ ▓▓▓▓▓ ▓▓ ▓▓ ▓▓▓▓▓ ▓▓▓▓▓ ▓▓ ▓▓ ▓
▓          ▓▓    ▓▓ ▓▓ ▓▓    ▓▓    ▓▓    ▓▓       ▓▓ ▓▓ ▓▓                   ▓▓             ▓▓          ▓▓ ▓▓    ▓▓    ▓▓          ▓▓       ▓
▓ ▓▓ ▓▓ ▓▓ ▓▓ ▓▓▓▓▓ ▓▓▓▓▓ ▓▓ ▓▓ ▓▓▓▓▓ ▓▓▓▓▓ ▓▓▓▓▓ ▓▓ ▓▓▓▓▓ ▓▓▓▓▓▓▓▓ ▓▓ ▓▓▓▓▓▓▓▓ ▓▓ ▓▓ ▓▓▓▓▓ ▓▓ ▓▓▓▓▓ ▓▓ ▓▓ ▓▓ ▓▓ ▓▓▓▓▓ ▓▓ ▓▓ ▓▓ ▓▓▓▓▓▓▓▓ ▓▓▓▓
▓ ▓▓ ▓▓ ▓▓ ▓▓ ▓▓▓▓▓ ▓▓▓▓▓ ▓▓ ▓▓ ▓▓▓▓▓ ▓▓▓▓▓ ▓▓▓▓▓ ▓▓ ▓▓▓▓▓ ▓▓▓▓▓▓▓▓ ▓▓ ▓▓▓▓▓▓▓▓ ▓▓ ▓▓ ▓▓▓▓▓ ▓▓ ▓▓▓▓▓ ▓▓ ▓▓ ▓▓ ▓▓ ▓▓▓▓▓ ▓▓ ▓▓ ▓▓ ▓▓▓▓▓▓▓▓ ▓▓▓▓
▓ ▓▓          ▓▓             ▓▓                   ▓▓       ▓▓ ▓▓                                  ▓▓                   ▓▓             ▓▓    ▓
▓ ▓▓ ▓▓ ▓▓ ▓▓ ▓▓▓▓▓ ▓▓▓▓▓ ▓▓ ▓▓▓▓▓ ▓▓ ▓▓ ▓▓ ▓▓ ▓▓ ▓▓ ▓▓ ▓▓ ▓▓ ▓▓ ▓▓▓▓▓ ▓▓ ▓▓ ▓▓ ▓▓ ▓▓▓▓▓▓▓▓ ▓▓▓▓▓▓▓▓ ▓▓ ▓▓ ▓▓ ▓▓ ▓▓▓▓▓ ▓▓ ▓▓ ▓▓▓▓▓▓▓▓▓▓▓ ▓▓ ▓
▓ ▓▓ ▓▓ ▓▓ ▓▓ ▓▓▓▓▓ ▓▓▓▓▓ ▓▓ ▓▓▓▓▓ ▓▓ ▓▓ ▓▓ ▓▓ ▓▓ ▓▓ ▓▓ ▓▓ ▓▓ ▓▓ ▓▓▓▓▓ ▓▓ ▓▓ ▓▓ ▓▓ ▓▓▓▓▓▓▓▓ ▓▓▓▓▓▓▓▓ ▓▓ ▓▓ ▓▓ ▓▓ ▓▓▓▓▓ ▓▓ ▓▓ ▓▓▓▓▓▓▓▓▓▓▓ ▓▓ ▓
▓       ▓▓    ▓▓ ▓▓    ▓▓          ▓▓    ▓▓    ▓▓                   ▓▓          ▓▓       ▓▓       ▓▓ ▓▓             ▓▓             ▓▓       ▓
▓▓▓▓▓▓▓ ▓▓ ▓▓▓▓▓ ▓▓ ▓▓ ▓▓ ▓▓ ▓▓ ▓▓▓▓▓ ▓▓ ▓▓ ▓▓ ▓▓ ▓▓ ▓▓ ▓▓▓▓▓ ▓▓▓▓▓▓▓▓▓▓▓ ▓▓ ▓▓ ▓▓ ▓▓ ▓▓ ▓▓ ▓▓▓▓▓ ▓▓▓▓▓ ▓▓▓▓▓ ▓▓ ▓▓▓▓▓ ▓▓ ▓▓ ▓▓▓▓▓▓▓▓▓▓▓▓▓▓ ▓
▓▓▓▓▓▓▓ ▓▓ ▓▓▓▓▓ ▓▓ ▓▓ ▓▓ ▓▓ ▓▓ ▓▓▓▓▓ ▓▓ ▓▓ ▓▓ ▓▓ ▓▓ ▓▓ ▓▓▓▓▓ ▓▓▓▓▓▓▓▓▓▓▓ ▓▓ ▓▓ ▓▓ ▓▓ ▓▓ ▓▓ ▓▓▓▓▓ ▓▓▓▓▓ ▓▓▓▓▓ ▓▓ ▓▓▓▓▓ ▓▓ ▓▓ ▓▓▓▓▓▓▓▓▓▓▓▓▓▓ ▓
▓       ▓▓    ▓▓             ▓▓       ▓▓ ▓▓       ▓▓ ▓▓             ▓▓ ▓▓       ▓▓       ▓▓       ▓▓       ▓▓       ▓▓       ▓▓    ▓▓       ▓
▓ ▓▓ ▓▓ ▓▓ ▓▓▓▓▓ ▓▓ ▓▓▓▓▓ ▓▓▓▓▓ ▓▓ ▓▓ ▓▓ ▓▓ ▓▓ ▓▓▓▓▓ ▓▓ ▓▓ ▓▓ ▓▓ ▓▓▓▓▓ ▓▓ ▓▓▓▓▓ ▓▓ ▓▓▓▓▓ ▓▓ ▓▓ ▓▓ ▓▓ ▓▓▓▓▓ ▓▓ ▓▓ ▓▓ ▓▓ ▓▓ ▓▓▓▓▓ ▓▓ ▓▓▓▓▓ ▓▓ ▓
▓ ▓▓ ▓▓ ▓▓ ▓▓▓▓▓ ▓▓ ▓▓▓▓▓ ▓▓▓▓▓ ▓▓ ▓▓ ▓▓ ▓▓ ▓▓ ▓▓▓▓▓ ▓▓ ▓▓ ▓▓ ▓▓ ▓▓▓▓▓ ▓▓ ▓▓▓▓▓ ▓▓ ▓▓▓▓▓ ▓▓ ▓▓ ▓▓ ▓▓ ▓▓▓▓▓ ▓▓ ▓▓ ▓▓ ▓▓ ▓▓ ▓▓▓▓▓ ▓▓ ▓▓▓▓▓ ▓▓ ▓
▓ ▓▓                         ▓▓          ▓▓                ▓▓    ▓▓ ▓▓             ▓▓ ▓▓                         ▓▓       ▓▓*               ▓
▓▓▓▓▓▓▓▓▓▓▓▓▓▓▓▓▓▓▓▓▓▓▓▓▓▓▓▓▓▓▓▓▓▓▓▓▓▓▓▓▓▓▓▓▓▓▓▓▓▓▓▓▓▓▓▓▓▓▓▓▓▓▓▓▓▓▓▓▓▓▓▓▓▓▓▓▓▓▓▓▓▓▓▓▓▓▓▓▓▓▓▓▓▓▓▓▓▓▓▓▓▓▓▓▓▓▓▓▓▓▓▓▓▓▓▓▓▓▓▓▓▓▓▓▓▓▓▓▓▓▓▓▓▓▓▓▓▓▓▓▓
